________________
WW_______BB_____
W_W_____________
WW______________
W_W_____________
WW______________ 
______II________
________________
________________
________________
________________
________________         
            