____________
WW_______BB_
W_W_________
WW__________
W_W_________
WW__________ 
______II____
____________
____________
____________
____________
____________         
            