WWWWWWWWWWWWWWWW
W______________W
W______________W
W______________W
W______________W
W______________W
W_____II_______W
W______________W
W______________W
W______________W
W______________W
WWWWWWWWWWWWWWWW
            