WWWWWWWWWWWW
WWWWWWWWWBB_
____WW______
____________
__W_________
____________ 
______II____
____________
____________
____________
BB__________
BBBBBBBBBBBB         
            