WWWWWWWWWWWW____
WWWWWWWWWBB_____
____WW__________
________________
__W_____________
________________ 
______II________
________________
________________
________________
BB______________
BBBBBBBBBBBB____         
            