WWWWWWWWWWWWBBBB
WWWWWWWWWBBBBBBB
____WW__________
________________
__W_____________
________________ 
________________
________________
________________
_________BBBBB__
BB_____BBBBBBBBB
BBBBBBBBBBBBBBBB